*********************
*...*.......*...*.*.*
*.*.***.***.*.***.*.*
*.*.....*...*.*.....*
*.**.****.*.*.***.*.*
*.......*.*.......*.*
*.***.*****.***.***.*
*.*.........*...*...*
*.*****.*****.***.*.*
*.*.*.......*.*...*.*
*.*.*.***.*******.*.*
*...*.*.........*...*
*.*.*.*****.*.*.*.***
*.*.....*.*...*.*...*
*.*.*****.***.***.*.*
*.....*...*.*.*.*.*.*
***.*****.*.*.*.***.*
*...*.*.*.*.*.....*.*
*.*.*.*.*.*.***.***.*
*.*.................*
*********************
